 22222222222-
 22223333342-
 22223222212-
533336222212-
 22222222212-
 22222241112-
 22222212222-
 22221162222-
 22221222222-
 61111112222-
 12221212222-
 12221112222-
 12222222222-
 41112222222-
 22212222222-
 22212222222-
 22212222222-
 22202222222