       5     -
2222222322222-
2222243333342-
2233336322212-
2212243422212-
2212222222212-
2212222222212-
2212222241112-
2312222212222-
2361111612222-
2322221212222-
2331111112222-
2232223232222-
2232223232222-
2232223332222-
2241122222222-
2222122222222-
2222122222222-
2222122222222-
2222022222222