    5    -
222232222-
222262222-
211132222-
212222222-
241112222-
222212222-
222212222-
222202222 